111111113111
100000000001
100000000001
500000000001
100000000001
3000000S0001
300000000001
100000000001
500000000001
100000000001
100000000001
100000000001
100000000001
101111141101
101222202101
101200002101
101500002101
101200009101
101229222101
101111111101
100000000001
100000000001
100000000001
100000000001
100000000001
100000000001
100000000001
100000000001
100000000001
100000000001
100000000001
100000000001
100000000001
100000000001
100000000001
100000000001
100000000001
100000000001
100000000001
100000000001
100000000001
100000000001
100000000001
100000000001
100000000001
100000000001
100000000001
100000000001
100000000001
100000000001
100000000001
100000000001
100000000001
100000000001
100000000001
100000000001
100000000001
100000000001
100000000001
100000000001
100000000001
111111111111
