111111111T111111111111111111111111111111111111111111111111111111111T111111
111F11F1FDF1F111111111111111111111111111111111111111111111111F11F11D11F111
11B000000r00BP111111111111111111111111111111111111111111111B0000000r000111
11000Fb00r0b1P1F1F1F1F1F1F1F1F1111111111111111111F1F1F1F1F100RaRRRRr000111
F00001000rbB1BB0000000000000000F111F1F1F1F1000000000000000000r00000r000F11
1B00010b0r001B0000000b000000000111PPPPPPPPP10RRRRRRRRRRRRRRRRr0b000r000111
1100B0000q0010000000b0000000000F1FBPPPPPPPPF0r00000000000000b000100r000F11
F00000000r001000000000000000000BPBPPPPPPPPP10r0BB00001111111b0001b0r000111
dRRRRRRRRRRRDRRRRRRRRRRRRRRRrRRPPPPPPPPPPPP00r000000000000001111100r0000F1
F0r00000000010B0000000000000rRRPPPPPPPPPPPPRRRRRRRRRRRRRRRRRRRRRRRRR000011
10r0B00000001F1F1F1F1F1F1F00r00bP1F11F11F1100000000000000000000000r00000F1
11D11100B1111111111111111100r001111111111111D11F111F111F111F111F10r0000011
11P1110001111111111111111F00r00111111111111F01F111111111111P111100r00000F1
11P1111111111111111111111111D11d1F11F11F11F1001111111111111P111F00r0000011
11P111111111111PPPPPPPPPP100r0F00B000000000000F111111111111P111100r0000BF1
1BPPPPPP1111111PPBPPPPPPPD00rB100000000000000B1111111111111P111F00r0001111
1PPPPPPPPPPPPBPP111111111100r0F01F11F11F11F1111111111111111P111100r000F111
1PPPPPPPPPPPPPPP111111111100r010111111111111111111111111111P111F00r0001111
1111PPP111111111111111111F00r0F0F11111111111111111111111111P111100r0001111
11111P1111111111111111111100r010111111111111111111111111111P111F00r0001111
11111P1111111111111111111F00r0F0F1111111111111111F111F11F11F11F110r0001111
11111P1111111111111111111100r0101111111111111111100B00000000000000r000B111
11111P1111111111111111111F00r010F111111111111111100000000000000000r0000F11
111F1D1F11111111111111111100r0001111111111111111FRRRRRRRRRRRRRRRRRR0000b11
11000r00001111IIAIII11111b00r000F1111111111111111r0000000000000000r00000F1
1F000r00001IIIIPPPPIIII1P000r0001F1F1F1F1F1F1F11PPP1F1000000000000r0010011
dRRRRRRRRRDPPPPPPPPPPPPDPRRRRRRRRRRRRRRRRRRR0011PPB111000000000100r00F00F1
1F0r0000r01IIIIPPPPIIII1P000b00000000000000r00F1PPP11F000000000100r0010011
110r0000r0F111IIIIII111111PS1F1F1F1F1F1F1F0r001F1D1111000000000FPPPPPF00F1
1F0r0000r01111111111111111PP111111111111110r00000R0F1F0000000001PPPPB10011
110r001Br00F1111111111111FPPF11111111111dRRRRRRRRRRd11B00000000FBPPPPF0BF1
1F0r00F0r001F111F111F11111BP111111111111110r0000000F11BB00000001BPPPP10B11
110r0010r0000000000000111FPP1F11F11F11F11F0r00000001111F11F11F11F1D1F11111
110r0010RRRRRRRRR000B1111100000000000000000r00B1FdFIIIIIAIIIIIIIIIPII11111
100r000000000000r00000011F11F11F11000000000r000F000IPPPPPPPPPPPPPPPPI11111
100r000000000000r000000PPPP0000000000000000r0001IIIIPPPPPPPPPPPPPPPPI11111
dRRRRRRRRRRRRRRRRRRRRRRPPPPRRRRRRRRRRRRRRRRRRRRDPPPPPPPPPPPPPPPPPPPPI11111
1000000000000000000000011F11F11F1100000000000001IIPPPPPPPPPPPPPPPPPPI11111
111F111F111F111F111F1111111111111111F11F11F11F111IIIIIIIIIIIIIIIIIIII11111
