IIIIIIIIIIIIIIIIIIIIIIIIIIIIIIIIIIIIIIIIIIIIIIIIIIIIIIIIIIIIIIIIIIIIIIIIIIIIIIIIIIIIIIIIIIIIIIIIIII
IIII0000000000000000000000000IIIIIIIIIIIIIIIIIIIIIIIIIIIIIIIIIIIIIIIIIIIIIIIIIIIIIIIIIIIIIIIIIIIIII
III00000000000000000000000000000IIIIIIIIIIIIIIIIIIIIIIIIIIIIIIIIIIIIIIIIIIIIIIIIIIIIIIIIIIIIIIIIIII
II000000000000000000000000000000000IIIIIIIIIIIIIIIIIIIIIIIIIIIIIIIIIIIIIIIIIIIIIIIIIIIIIIIIIIIIIIII
I0000000000000000000000000000000000000IIIIIIIIIIIIIIIIIIIIIIIIIIIIIIIIIIIIIIIIIIIIIIIIIIIIIIIIIIIII
I0000000000000000000000000000000000000000IIIIIIIIIIIIIIIIIIIIIIIIIIIIIIIIIIIIIIIIIIIIIIIIIIIIIIIIII
I000000000000IIIIIIIIIIIIIIII000000000000000IIIIIIIIIIIIIIIIIIIIIIIIIIIIIIIIIIIIIIIIIIIIIIIIIIIIIII
I0000000000IIIIIIIIIIIIIIIIIIII000000000000000IIIIIIIIIIIIIIIIIIIIIIIIIIIIIIIIIIIIIIIIIIIIIIIIIIIII
I00000000IIIIIIIIIIIIIIIIIIIIIIIII00000000000000IIIIIIIIIIIIIIIIIIIIIIIIIIIIIIIIIIIIIIIIIIIIIIIIIII
I00000000IIIIIIIIIIIIIIIIIIIIIIIIIII000000000000IIIIIIIIIIIIIIIIIIIIIIIIIIIIIIIIIIIIIIIIIIIIIIIIIII
I00000000IIIIIIIIIIIIIIIIIIIIIIIIIII000000000000IIIIIIIIIIIIIIIIIIIIIIIIIIIIIIIIIIIIIIIIIIIIIIIIIII
I00000000IIIIIIIIIIIIIIIIIIIIIIIIII0000000000000IIIIIIIIIIIIIIIIIIIIIIIIIIIIIIIIIIIIIIIIIIIIIIIIIII
I00000000IIIIIIIIIIIIIIIIIIIIIIII00000000000000IIIIIIIIIIIIIIIIIIIIIIIIIIIIIIIIIIIIIIIIIIIIIIIIIIII
I000000000IIIIIIIIIIIIIIIIIIIII000000000000000IIIIIIIIIIIIIIIIIIIIIIIIIIIIIIIIIIIIIIIIIIIIIIIIIIIII
I00000000000IIIIIIIIIIIIIIIIII000000000000000IIIIIIIIIIIIIIIIIIIIIIIIIIIIIIIIIIIIIIIIIIIIIIIIIIIIII
I0000000000000IIIIIIIIIIIIIII0000000000000000000000000000000000000000000000000000IIIIIIIIIIIIIIIIII
I000000000000000IIIIIIIIIIIIII00000000000000000000000000000000000000000000000000000IIIIIIIIIIIIIIII
I00000000000000000IIIIIIIIIIIII000000000000000000000000000000000000000000000000000000IIIIIIIIIIIIII
I000000000000000000IIIIIIIIIIIII00000000000000000000000000000000000000000000000000000000IIIIIIIIIII
I000000000000000000IIIIIIIIIIIIIIII00000000000000000000000000000000000000000000000000000000IIIIIIII
I000000000000000000IIIIIIIIIIIIIIIIIIIIIIIIIIIIIIIIIIIIIIIIIIIIIIIIIIIIIIIIIIII000000000000IIIIIIII
I000000000000000000IIIIIIIIIIIIIIIIIIIIIIIIIIIIIIIIIIIIIIIIIIIIIIIIIIIII0000000000000000000IIIIIIII
I000000000000000000IIIIIIIIIIIIIIIIIIIIIIIIIIIIIIIIIIIIIIIIIIIIIIII00000000000000000000000IIIIIIIII
I000000000000000000IIIIIIIIIIIIIIIIIIIIIIIIIIIIIIIIIIIIIIIIIIII0000000000000000000000000IIIIIIIIIII
I00000000S000000000IIIIIIIIIIIIIIIIIIIIIIIIIIIIIIIIII000000000000000000000000000000IIIIIIIIIIIIIIII
I000000000000000000IIIIIIIIIIIIIIIIIIIIIIII0000000000000000000000000000000000IIIIIIIIIIIIIIIIIIIIII
I000000000000000000IIIIIIIIIIIIIIIII00000000000000000000000000000000000IIIIIIIIIIIIIIIIIIIIIIIIIIII
I000000000000000000IIIIIIIIIIIIIIIII00000000000000000000000000000000IIIIIIIIIIIIIIIIIIIIIIIIIIIIIII
I000000000000000000IIIIIIIIIIIIIIIII00000000000000000000000000IIIIIIIIIIIIIIIIIIIIIIIIIIIIIIIIIIIII
I000000000000000000IIIIIIIIIIIIIIIIII00000000000000000000IIIIIIIIIIIIIIIIIIIIIIIIIIIIIIIIIIIIIIIIII
I000000000000000000IIIIIIIIIIIIIIIIIIII00000000000000000000000000000000000IIIIIIIIIIIIIIIIIIIIIIIII
I000000000000000000IIIIIIIIIIIIIIIIIIIIIII0000000000000000000000000000000000000IIIIIIIIIIIIIIIIIIII
I000000000000000000IIIIIIIIIIIIIIIIIIIIIIIIIII0000000000000000000000000000000000000IIIIIIIIIIIIIIII
I000000000000000000IIIIIIIIIIIIIIIIIIIIIIIIIIIIII0000000000000000000000000000000000000000IIIIIIIIII
I000000000000000000IIIIIIIIIIIIIIIIIIIIIIIIIIIIIIIIII0000000000000000000000000000000000000000IIIIII
I000000000000000000IIIIIIIIIIIIIIIIIIIIIIIIIIIIIIIIIIIIII00000000000000000000000000000000000000IIII
I000000000000000000IIIIIIIIIIIIIIIIIIIIIIIIIIIIIIIIIIIIIIIIIIIIIIIIIIIIIII00000000000000000000IIIII
I000000000000000000IIIIIIIIIIIIIIIIIIIIIIIIIIIIIIIIIIIIIIIIIIIIIIIIIIIIIIIIII00000000000000000IIIII
I000000000000000000IIIIIIIIIIIIIIIIIIIIIIIIIIIIIIIIIIIIIIIIIIIIIIIIIIIIIIIIIIII000000000000000IIIII
I000000000000000000IIIIIIIIIIIIIIIIIIIIIIIIIIIIIIIIIIIIIIIIIIIIIIIIIIIIIIIIII0000000000000000IIIIII
I000000000000000000IIIIIIIIIIIIIIIIIIIIIIIIIIIIIIIIIIIIIIIIIIIIIIIIIIII000000000000000000000IIIIIII
I000000000000000000IIIIIIIIIIIIIIIIIIIIIIIIIIIIIIIIIIIIIIIIIIIIIIII0000000000000000000000IIIIIIIIII
I000000000000000000IIIIIIIIIIIIIIIIIIIIIIIIIIIIIIIIIIIIIIIIIII00000000000000000000000IIIIIIIIIIIIII
I000000000000000000IIIIIIIIIIIIIIIIIIIIIIIIIIIIIIIIIIIIIII0000000000000000000000000IIIIIIIIIIIIIIII
I000000000000000000IIIIIIIIIIIIIIIIIIIIIIIIIIIIIIIIIII000000000000000000000IIIIIIIIIIIIIIIIIIIIIIII
I000000000000000000IIIIIIIIIIIIIIIIIIIIIIIIIIIIIIII000000000000000000IIIIIIIIIIIIIIIIIIIIIIIIIIIIII
I000000000000000000IIIIIIIIIIIIIIIIIIIIIIIIII00000000000000000000IIIIIIIIIIIIIIIIIIIIIIIIIIIIIIIIII
I000000000000000000IIIIIIIIIIIIIIIIIIIIII0000000000000000000000IIIIIIIIIIIIIIIIIIIIIIIIIIIIIIIIIIII
I000000000000000000IIIIIIIIIIIIIIIIIIIIII000000000000000000IIIIIIIIIIIIIIIIIIIIIIIIIIIIIIIIIIIIIIII
I000000000000000000IIIIIIIIIIIIIIIIIIIIII0000000000000000IIIIIIIIIIIIIIIIIIIIIIIIIIIIIIIIIIIIIIIIII
I000000000000000000IIIIIIIIIIIIIIIIIIIIII000000000000000IIIIIIIIIIIIIIIIIIIIIIIIIIIIIIIIIIIIIIIIIII
I000000000000000000IIIIIIIIIIIIIIIIIIIIII00000000000000IIIIIIIIIIIIIIIIIIIIIIIIIIIIIIIIIIIIIIIIIIII
I000000000000000000IIIIIIIIIIIIIIIIIIIIIIII00000000000000000IIIIIIIIIIIIIIIIIIIIIIIIIIIIIIIIIIIIIII
I000000000000000000IIIIIIIIIIIIIIIIIIIIIIIIIII000000000000000000IIIIIIIIIIIIIIIIIIIIIIIIIIIIIIIIIII
I0000000000000000000IIIIIIIIIIIIIIIIIIIIIIIIIIIIII0000000000000000IIIIIIIIIIIIIIIIIIIIIIIIIIIIIIIII
I00000000000000000000IIIIIIIIIIIIIIIIIIIIIIIIIIIIIIII0000000000000000IIIIIIIIIIIIIIIIIIIIIIIIIIIIII
I000000000000000000000IIIIIIIIIIIIIIIIIIIIIIIIIIIIIIIIII0000000000000000000IIIIIIIIIIIIIIIIIIIIIIII
II000000000000000000000IIIIIIIIIIIIIIIIIIIIIIIIIIIIIIIIIII000000000000000000000IIIIIIIIIIIIIIIIIIII
II0000000000000000000000IIIIIIIIIIIIIIIIIIIIIIIIIIIIIIIIIIIIII00000000000000000000IIIIIIIIIIIIIIIII
III00000000000000000000000IIIIIIIIIIIIIIIIIIIIIIIIIIIIIIIIIIIIIIIIII0000000000000000IIIIIIIIIIIIIII
IIII00000000000000000000000IIIIIIIIIIIIIIIIIIIIIIIIIIIIIIIIIIIIIIII00000000000000000IIIIIIIIIIIIIII
IIIIII0000000000000000000000IIIIIIIIIIIIIIIIIIIIIIIIIIIIIIIIIIIII00000000000000000000IIIIIIIIIIIIII
IIIIIIII0000000000000000000000IIIIIIIIIIIIIIIIIIIIIIIIIIIIIIIII00000000000000000000000IIIIIIIIIIIII
IIIIIIIIII0000000000000000000000IIIIIIIIIIIIIIIIIIIIIIIIIIIII000000000000000000000000IIIIIIIIIIIIII
IIIIIIIIIIII00000000000000000000000000000000000000000000000000000000000000000000000IIIIIIIIIIIIIIII
IIIIIIIIIIIIIII000000000000000000000000000000000000000000000000000000000000000000IIIIIIIIIIIIIIIIII
IIIIIIIIIIIIIIIII00000000000000000000000000000000000000000000000000000000000000IIIIIIIIIIIIIIIIIIII
IIIIIIIIIIIIIIIIIIIII000000000000000000000000000000000000000000000000000000000IIIIIIIIIIIIIIIIIIIII
IIIIIIIIIIIIIIIIIIIIIIIII00000000000000000000000000000000000000000000000000IIIIIIIIIIIIIIIIIIIIIIII
IIIIIIIIIIIIIIIIIIIIIIIIIIIIIIIIIIIIIIIIIIIIIIIIIIIIIIIIIIIIIIIIIIIIIIIIIIIIIIIIIIIIIIIIIIIIIIIIIII
